111111111111
1P10001010C1
10101C101011
100011100001
101110001111
1000001000E1
111111111111