111111111111111111111111111
1P100C001000000000000000001
101011101011111110111011101
10101010101E1000100000000C1
1C1000101000101010111011111
100010000010001000000000N01
111111111111111111111111111