111111111
10P00C001
100000001
100000001
10N00E001
111111111