111111111111111
1P000000C1000C1
111111001110111
1000000000101E1
101111101110101
10000C100000001
111111111111111